# Resources from editor.txt
askZoom=输入缩放比例 (%)
properties=属性
tasks=任务
# Resources from graph.txt
alreadyConnected=节点已经连接
cancel=取消
close=关闭
collapse-expand=允许图元折叠/展开
containsValidationErrors=包含验证错误
done=完成
doubleClickOrientation=双击切换方向
error=错误
errorSavingFile=保存文件错误
ok=OK
updatingDocument=更新文档，请等待...
updatingSelection=更新选择，请等待...
# Custom resources
actualSize=实际大小
add=添加
addLayer=添加层
addProperty=添加属性
addToExistingDrawing=添加到已存在图
addWaypoint=添加轨迹点
advanced=高级
align=对齐
alignment=对齐方式
allChangesLost=所有变化将丢失！
angle=角度
apply=应用
arc=弧
arrange=排列
arrow=箭头
arrows=箭头
automatic=自动
autosave=自动保存
autosize=自动大小
back=回退
background=背景
backgroundColor=背景颜色
backgroundImage=背景图片
basic=基础
bindProperties=绑定属性
block=块
blockquote=Blockquote
bold=粗体
border=边界
borderWidth=边界宽
borderColor=边界颜色
bottom=底部
bottomAlign=底部对齐
bottomLeft=左下
bottomRight=右下
bulletedList=项目列表
cannotOpenFile=无法打开文件
center=中间
change=变化
changeOrientation=更改方向
circle=圆
classic=经典
clearDefaultStyle=清除默认样式
clearWaypoints=清除轨迹点
collapse=折叠
collapseExpand=允许图元折叠/展开
collapsible=可折叠
comic=漫画风格
connect=连接
connection=连接
splitWay=轨迹线可分割
connectionArrows=显示连接箭头
connectionPoints=显示连接热点
constrainProportions=限制比例
copy=复制
copyConnect=Copy on Connect
copySize=复制大小
create=创建
curved=弯曲
custom=定制
cut=剪贴
dashed=虚线
decreaseIndent=减小缩进
default=默认
delete=删除
deleteColumn=删除列
deleteRow=删除行
diagram=格式
diamond=菱形
diamondThin=菱形 (瘦)
direction=方向
distribute=分配
divider=分割
documentProperties=文档属性
dotted=点线
dpi=DPI
drawing=图{1}
drawingEmpty=空图
drawingTooLarge=图太大
duplicate=重复
duplicateIt=重复 {1}
east=向右
edit=编辑
editDiagram=显示图元数据
editImage=编辑图片
editStyle=编辑样式
enterGroup=加入组
enterValue=输入值
enterName=输入名称
enterPropertyName=输入属性名
entityRelation=实体关系
exitGroup=退出组
expand=展开
export=导出
extras=附加
file=文件
fileNotFound=文件找不到
filename=文件名
fill=填充
fillColor=填充颜色
fitPage=一页
fitPageWidth=页宽
fitTwoPages=两页
fitWindow=适合窗口
flip=翻转
flipH=水平翻转
flipV=垂直翻转
flowchart=流程图
font=字体
fontFamily=字体
fontColor=字体颜色
fontSize=字体大小
format=格式
formatPanel=格式面板
# formatPdf=PDF
# formatPng=PNG
# formatGif=GIF
# formatJpg=JPEG
formatSvg=SVG
formatXml=XML
formatted=格式化
formattedText=格式化文字
gap=空隙
glass=玻璃
general=普通
global=全局
gradient=渐变
gradientColor=颜色
grid=网格
gridSize=网格大小
group=组合
guides=编辑对齐指引
heading=标题
height=高度
hide=隐藏
hideIt=隐藏 {1}
hidden=已隐藏
home=主页
horizontal=水平
horizontalFlow=水平流
horizontalTree=水平树
html=HTML
id=ID
image=图片
images=图片
import=导入
increaseIndent=增加缩进
insert=插入
insertColumnBefore=左边插入列
insertColumnAfter=右边插入列
insertHorizontalRule=插入水平标尺
insertImage=插入图片
insertRowBefore=上部插入行
insertRowAfter=下部插入行
invalidInput=无效输入
invalidName=无效名
invalidOrMissingFile=无效/丢失的文件
isometric=等距
italic=斜体
layers=层
laneColor=Lanecolor
layout=布局
left=左
leftAlign=左对齐
leftToRight=从左到右
line=线
link=链接
lineJumps=线跨越方式
lineend=线结尾
lineheight=线高度
linestart=线起始
linewidth=线宽
loading=加载
lockUnlock=锁定/解锁
manual=人工
middle=中间
misc=组合
more=更多
moreResults=更多结果
move=移动
moveSelectionTo=移动选中到 {1}
navigation=导航
new=新建
noColor=无颜色
noFiles=无文件
noMoreResults=没有结果
none=无
noResultsFor=没有 '{1}' 的结果
normal=正常
north=向上
numberedList=编号列表
opacity=不透明
open=打开
openArrow=打开箭头
openFile=打开文件
openLink=打开链接
openSupported=吉安电子科技有限公司数据采集组态画面.XML文件
openInNewWindow=在新窗口中打开
openInThisWindow=在本窗口中打开
options=选项
organic=有组织的
orthogonal=正交
outline=轮廓
oval=椭圆
pages=页
pageScale=页比例
#pageSetup=页设置
panTooltip=Space+Drag to Scroll
paperSize=页面大小
paste=粘贴
pasteHere=粘贴在此
pasteSize=粘贴大小
pattern=模式
perimeter=边缘
plusTooltip=点击连接并复制 (ctrl+click复制, shift+click连接). 拖动连接 (ctrl+drag复制).
position=位置
posterPrint=Poster Print
#preview=预览
#print=打印
radial=径向
radialTree=径向树
redo=重做
removeFormat=清除格式
removeFromGroup=从组中移除
removeIt=移除 {1}
removeWaypoint=移除轨迹点
rename=重命名
renameIt=重命名为 {1}
replace=替换
replaceIt={1} 已经存在,要替换?
replaceExistingDrawing=替换当前图
reset=复位
resetView=复位视图
reverse=保留
right=右
rightAlign=右对齐
rightToLeft=从右到左
rotate=旋转
rotateTooltip=点选拖动旋转, 单击旋转90度
rotation=旋转
rounded=圆角
save=保存
saveAndReturn=保存并返回
nosaveAndReturn=不保存返回
saved=已保存
scrollbars=滚动条
search=搜索
searchDevs=设备关键字
searchVars=变量关键字
selectAll=选择全部
selectEdges=选择边
selectFont=选择一个字体
selectNone=无选择
selectVertices=选择顶点
setAsDefaultStyle=设为默认样式
shadow=阴影
shape=图元
sharp=Sharp
sidebarTooltip=点击扩展. 拖放图元到页面中. Shift+click更换选中图元. Alt+click插入并连接.
simple=简单
simpleArrow=简单箭头
size=尺寸
solid=实心
sourceSpacing=Source Spacing
south=向下
spacing=间距
straight=直的
strikethrough=删除线
strokeColor=线颜色
style=样式
subscript=下标
superscript=上标
table=表格
targetSpacing=Target Spacing
text=文字
textAlignment=文本对齐
textOpacity=文本不透明度
themes=主题
toBack=置后
toFront=置前
tooltips=提示
top=顶部
topAlign=顶部对齐
topLeft=左上
topRight=右上
transparent=透明
turn=旋转90°
uml=UML
underline=下划线
undo=撤销
ungroup=解组
untitledLayer=Untitled Layer
url=URL
version=显示版本历史
vertical=垂直
verticalFlow=垂直流
verticalTree=垂直树
view=视图
waypoints=轨迹点
west=向左
width=宽带
wordWrap=自动换行
writingDirection=书写方向
zoom=缩放
zoomIn=放大
zoomOut=缩小
